%%%%%%%%
%+%+  +%
% - +%-%
%  - + %
%  S- +%
% %%%- %
%      %
%%%%%%%%