%%%%%%%%%
%       %
%       %
%       %
%  S    %
%       %
%       %
%      +%
%%%%%%%%%